15 15
##S### ########
## ### ########
#   #  # ## ###
#       #######
#  # # ########
#  ### ########
#  ### # ######
###### ########
###### ########
###### ########
###### ########
######G########
###############
###############
###############
